border_size=1
usage=map

_off^_usr   , _off^_usr   , Xu          , Uh          , Uu          , Xu          , Xu          , _off^_usr   , _off^_usr   , _off^_usr   , _off^_usr   , _off^_usr   , _off^_usr   , _off^_usr   , _off^_usr   , _off^_usr   , Xu          , _off^_usr   , Xu          , Uu          , Uu          , Uu          
_off^_usr   , _off^_usr   , Xu          , Uh          , Uu          , Uu          , Uu          , Xu          , _off^_usr   , _off^_usr   , _off^_usr   , _off^_usr   , _off^_usr   , _off^_usr   , Xu          , Xu          , Cud         , Xu          , Xu          , Uu          , Re          , Uu          
_off^_usr   , _off^_usr   , _off^_usr   , Xu          , Xu          , Uu          , Uu          , Xu          , Xu          , _off^_usr   , _off^_usr   , _off^_usr   , _off^_usr   , Xu          , Uu          , Uu          , 3 Kud       , Uu          , Uu          , Uu^Vud      , Re          , Uu          
_off^_usr   , _off^_usr   , _off^_usr   , _off^_usr   , Xu          , Uh          , Uh          , Uu          , Xu          , _off^_usr   , _off^_usr   , _off^_usr   , _off^_usr   , Xu          , Uu^Vud      , Cud         , Re          , Cud         , Re          , Re          , Uh          , Uu          
_off^_usr   , _off^_usr   , _off^_usr   , _off^_usr   , _off^_usr   , Xu          , Uu          , Uu          , Xu          , _off^_usr   , Xu          , _off^_usr   , Xu          , Xu          , Uu          , Uu          , Re          , Uu          , Uu          , Uu          , Xu          , Xu          
_off^_usr   , _off^_usr   , _off^_usr   , _off^_usr   , Xu          , Xu          , Xu          , Xu          , Xu          , Xu          , Uh          , Xu          , Qxu         , Xu          , Cud         , Uu          , Uu          , Uu          , Uu^Vud      , Uh          , Xu          , _off^_usr   
_off^_usr   , _off^_usr   , _off^_usr   , Xu          , Uh          , Uu          , Uu          , Uu          , Uu          , Uu          , Uu          , Uh          , Uu^Vud      , Uh          , Re          , Re          , Cud         , Uu          , Uh          , Xu          , _off^_usr   , _off^_usr   
_off^_usr   , _off^_usr   , Xu          , Xu          , Uh          , Uu          , Uu          , Uu          , Uh          , Uu^Uf       , Uu          , Uu          , Uu          , Uu          , Uu          , Uu          , Uh          , Cud         , Xu          , Xu          , _off^_usr   , _off^_usr   
Xu          , Xu          , Qxu         , Uh          , Uu          , Uu          , Qxu         , Qxu         , Uu          , Uu          , Re          , Uh          , Re          , Re          , Uu          , Uh          , Xu          , Xu          , Xu          , Xu          , _off^_usr   , _off^_usr   
Xu          , Uu          , Qxu         , Uu          , Uu          , Uu          , Uu          , Uh          , Re          , Re          , Uu          , Re          , Uu          , Uu          , Uu          , Qxu         , Xu          , Xu          , _off^_usr   , _off^_usr   , _off^_usr   , _off^_usr   
Xu          , Uu^Uf       , Uu          , Uu          , Uu          , Uu          , Uu^Vu       , Uu          , Re          , Uu          , Uh          , Uu          , Xu          , Uh          , Xu          , Xu          , _off^_usr   , _off^_usr   , _off^_usr   , _off^_usr   , _off^_usr   , _off^_usr   
_off^_usr   , Xu          , Uu^Uf       , Uu^Uf       , Uu          , Uu^Uf       , Re          , Re          , Re          , Uu^Vu       , Uu^Uf       , Xu          , Xu          , Xu          , Xu          , Xu          , Xu          , Xu          , Xu          , _off^_usr   , _off^_usr   , _off^_usr   
_off^_usr   , Xu          , Xu          , Uu^Uf       , Uu^Vu       , Re          , Uh          , Uu          , Uu          , Uu          , Ww          , Xu          , Ww          , Ww          , Ww          , Wo          , Wo          , Wo          , Xu          , _off^_usr   , _off^_usr   , _off^_usr   
_off^_usr   , Xu          , Uu^Uf       , Uu^Uf       , Re          , Re          , Uu          , Xu          , Ww          , Uu          , Ww^Bw\      , Ww          , Xu          , Xu          , Xu          , Xu          , Xu          , Xu          , _off^_usr   , _off^_usr   , _off^_usr   , _off^_usr   
_off^_usr   , Xu          , Xu          , 2 Uu^Vu     , Uu^Uf       , Uu          , Xu          , Xu          , Ww          , Ww          , Uu          , Uu          , Uu          , Xu          , Xu          , _off^_usr   , _off^_usr   , _off^_usr   , _off^_usr   , _off^_usr   , _off^_usr   , _off^_usr   
_off^_usr   , _off^_usr   , _off^_usr   , Xu          , Xu          , Xu          , Wo          , Ww          , Xu          , Xu          , Xu          , Re          , Re          , Uu          , Uu          , Xu          , _off^_usr   , _off^_usr   , Xu          , Xu          , Xu          , _off^_usr   
_off^_usr   , _off^_usr   , _off^_usr   , _off^_usr   , Xu          , Wo          , Xu          , Xu          , _off^_usr   , _off^_usr   , Xu          , Uu          , Uu          , Re          , Uu          , Xu          , Xu          , Xu          , Uu^Uf       , Uu^Uf       , Xu          , _off^_usr   
_off^_usr   , _off^_usr   , _off^_usr   , _off^_usr   , Xu          , Wo          , Xu          , _off^_usr   , _off^_usr   , _off^_usr   , _off^_usr   , Xu          , Xu          , Re          , Uu          , Uh          , Xu          , Uu^Vu       , Re          , Uu^Uf       , Xu          , _off^_usr   
_off^_usr   , _off^_usr   , _off^_usr   , _off^_usr   , _off^_usr   , Xu          , _off^_usr   , _off^_usr   , _off^_usr   , _off^_usr   , _off^_usr   , _off^_usr   , Xu          , Uu^Uf       , Uu          , Uu          , Uu^Vu       , Re          , Uu^Uf       , Xu          , Xu          , _off^_usr   
_off^_usr   , _off^_usr   , _off^_usr   , _off^_usr   , _off^_usr   , _off^_usr   , _off^_usr   , _off^_usr   , _off^_usr   , _off^_usr   , _off^_usr   , _off^_usr   , Xu          , Uu^Uf       , Uu^Uf       , Re          , Re          , Re          , 1 Uu^Vu     , Uu^Uf       , Uh          , Xu          
_off^_usr   , _off^_usr   , _off^_usr   , _off^_usr   , _off^_usr   , _off^_usr   , _off^_usr   , _off^_usr   , _off^_usr   , _off^_usr   , _off^_usr   , _off^_usr   , _off^_usr   , Xu          , Uu^Uf       , Uu^Vu       , Uh          , Re          , Re          , Re          , Uu^Uf       , Xu          
_off^_usr   , _off^_usr   , _off^_usr   , _off^_usr   , _off^_usr   , _off^_usr   , _off^_usr   , _off^_usr   , _off^_usr   , _off^_usr   , _off^_usr   , _off^_usr   , _off^_usr   , Xu          , Xu          , Uu          , Uu          , Uu          , Re          , Uu          , Uu          , Uh          
