border_size=1
usage=map

Gg          , Gg          , Gg^Fet      , Gg          , Gs^Fp       , Gs^Fp       , Gs^Fp       , Gg          , Gs^Fp       , Gg          , Hh          , Mm          , Mm^Xm       , Gg          , Xu          , Xu          , Xu          , Xu          , Xu          , Xu          , Xu          , Xu          , Xu          
Gs^Fp       , Gg^Fet      , Gs          , Gs^Fp       , Gg^Fet      , Gs^Fp       , Gg^Fet      , Gs^Fp       , Gg^Fet      , Gg          , Hh          , Mm          , Hh          , Mm^Xm       , Xu          , Qxu         , Re          , Xu          , Re          , Qxu         , Re          , Xu          , Xu          
Gg          , Gs^Fp       , Gg          , Gs^Fp       , Gs          , Gs^Fp       , Gg          , Gs          , Gs          , Gs^Fp       , Gg^Fet      , Hh          , Mm          , Mm^Xm       , Mm^Xm       , Xu          , Uu          , Re          , Uu          , Uu          , Uu          , Re          , Xu          
Gs          , Gg^Fet      , Gs^Fp       , Gs^Fp       , Gs          , Gs^Fp       , Gs^Fp       , Gs^Fp       , Gg^Fet      , Gs^Fp       , Gs^Fp       , Hh          , Mm          , Mm          , Ce          , Xu          , Uu^Vu       , Uu          , Uu          , Uu          , Uu          , Re          , Xu          
Gs          , Gs          , Gs^Fp       , Gg          , Gg^Fet      , Gs^Fp       , Gg^Fet      , Gg          , Gs^Fp       , Gs          , Gg^Fet      , Hh          , Ce          , Ce          , Re          , Ce          , 1 Ke        , Uu          , Re          , Uu          , Re          , Re          , Xu          
Gs^Fp       , Gg^Fet      , Gg          , Gs^Fp       , Gs^Fp       , Gs^Fp       , Gs^Fp       , Gs^Fp       , Gs          , Gs          , Gs          , Gs          , Ce          , Re          , Re          , Re          , Re          , Ce          , Ce          , Uu^Vu       , Re          , Xu          , Xu          
Gg          , Gg          , Gs^Fp       , Gg^Fet      , Gs^Fp       , Gg^Fet      , Gs          , Gs          , Gg^Fet      , Gs          , Gs          , Gs          , Ce          , Re          , Ce          , Re          , Ce          , Ce          , Xu          , Uu          , Re          , Xu          , Xu          
Gg          , Gs^Fp       , Gs^Fp       , Gs          , Gs^Fp       , Gg^Fet      , Gs^Fp       , Gs^Fp       , Gs          , Gg          , Gg          , Gg          , Re          , Ce          , Hh          , Ce          , Mm          , Mm^Xm       , Mm^Xm       , Xu          , Xu          , Xu          , Xu          
Gs^Fp       , Gg^Fet      , Gs          , Gs^Fp       , Gs          , Gs^Fp       , Gg^Fet      , Gs^Fp       , Gs          , Gg          , Gg          , Re          , Gs          , Gs          , Gs          , Mm          , Hh          , Mm          , Mm          , Mm^Xm       , Mm^Xm       , Xu          , Xu          
Gg          , Gs^Fp       , Gs^Fp       , Gg^Fet      , Gs^Fp       , Gs          , Gs          , Gs          , Gg          , Gg          , Gg          , Re          , Gs          , Gs          , Gs^Fp       , Gs          , Hh          , Hh          , Hh          , Mm          , Hh          , Mm^Xm       , Xu          
Gg^Fet      , Gg          , Gg^Fet      , Gs^Fp       , Gs          , Gs          , Gs          , Gs          , Gg          , Ggf         , Re          , Re          , Gg          , Gs          , Gs^Fp       , Gs          , Gg^Fet      , Gs^Fp       , Gs^Fp       , Gs^Fp       , Hh          , Mm^Xm       , Mm^Xm       
Gs^Fp       , Gs^Fp       , Gs^Fp       , Gg          , Gg          , Gs          , Gs          , Gs          , Gs          , Gg          , Re          , Gg          , Ggf         , Gg          , Gs^Fp       , Gs          , Gs^Fp       , Gs^Fp       , Gs^Fp       , Gg^Fet      , Gs          , Mm          , Mm          
Gg^Fet      , Gg          , Gg          , Ggf         , Gg          , Gg          , Gs          , Gs          , Gs          , Gg          , Gs          , Re          , Gg          , Gs^Fp       , Gg^Fet      , Gg          , Gs^Fp       , Gg          , Gs^Fp       , Gs^Fp       , Gs^Fp       , Hh          , Hh          
Gs^Fp       , Gg          , Ggf         , Gg          , Re^Gvs      , Re^Gvs      , Re^Gvs      , Gs          , Gs          , Gs          , Re          , Re          , Gs^Vht      , Gg          , Gg          , Gs^Fp       , Gs^Fp       , Gg^Fet      , Gs^Fp       , Gg          , Gs^Fp       , Gg^Fet      , Gs^Fp       
Gs^Fp       , Gs^Fp       , Gs          , Re^Gvs      , Re^Gvs      , Re^Gvs      , Re          , Gs          , Re          , Gs^Vht      , Re          , Gs          , Gs          , Gg          , Gg          , Ggf         , Gg          , Gs^Fp       , Gs^Fp       , Gg          , Gs^Fp       , Gs^Fp       , Gg          
Gs          , Gg^Fet      , Gs^Fp       , Gs          , Gs          , Gg          , Gg          , Re          , Gs          , Re          , Gs^Vht      , Gs          , Re^Gvs      , Re^Gvs      , Re^Gvs      , Gg          , Gs^Fp       , Gs^Fp       , Ggf         , Gs^Fp       , Gg^Fet      , Gs^Fp       , Gs^Fp       
Gs^Fp       , Gs^Fp       , Ggf         , Gs          , Gs          , Gs^Vht      , Re          , Re          , Gs          , Re          , Re          , Gs          , Gs^Vht      , Re^Gvs      , Gg          , Gg          , Gs^Fp       , Gg          , Gs^Fp       , Gg          , Gs^Fp       , Gs^Fp       , Gs^Fp       
Gg^Fet      , Gg          , Re^Gvs      , Re^Gvs      , Re^Gvs      , Re          , Ggf         , Gs          , Gs^Vht      , Re          , Gs^Vht      , Re          , Gg          , Gg          , Ggf         , Gg          , Gs^Fp       , Gg^Fet      , Gs^Fp       , Gs^Fp       , Gs^Fp       , Gs^Fp       , Gg          
Gs^Fp       , Gg          , Gs          , Re^Gvs      , Re^Gvs      , Re^Gvs      , 2 Gg        , Gg          , Gg          , Gs          , Gs          , Re          , Re          , Gg          , Gg          , Gs^Fp       , Gs^Fp       , Gg          , Gs          , Gs          , Gg^Fet      , Gg          , Gg          
Gg          , Gs^Fp       , Gs          , Gs          , Gs          , Gg          , Gg          , Ggf         , Gg          , Gs          , Gs          , Gs          , Gs          , Re          , Gg          , Gs^Fp       , Gs^Fp       , Gg          , Gg^Fet      , Gs          , Gs^Fp       , Gg          , Gs^Fp       
Gs^Fp       , Gg^Fet      , Gs          , Gs          , Gs          , Gg          , Gs          , Gs          , Gs          , Gs          , Gs          , Gs          , Gs          , Re          , Re          , Gs^Fp       , Gg^Fet      , Gs^Fp       , Gs^Fp       , Gs^Fp       , Gs          , Gs^Fp       , Gg          
Gg          , Gs^Fp       , Gs^Fp       , Gs          , Gs^Fp       , Gs          , Gg^Fet      , Gs          , Gs^Fp       , Gs          , Gg^Fet      , Gs          , Gs^Fp       , Gs^Fp       , Gs^Fp       , Re          , Gs^Fp       , Gs^Fp       , Gs^Fp       , Gs          , Gs^Fp       , Gg^Fet      , Gg          
Gg          , Gg          , Gg          , Gs^Fp       , Gg          , Gs^Fp       , Gg          , Gs^Fp       , Gg          , Gs^Fp       , Gg          , Gs^Fp       , Gs^Fp       , Gg^Fet      , Gg          , Re          , Gs^Fp       , Gg^Fet      , Gg          , Gg^Fet      , Gg          , Gs^Fp       , Gs^Fp       
