border_size=1
usage=map

_off^_usr   , _off^_usr   , _off^_usr   , _off^_usr   , Xu          , _off^_usr   , _off^_usr   , _off^_usr   , Xu          , Xu          , Xu          , Xu          , Xu          , Xu          , Xu          , Xu          , Xu          , Xu          , Xu          , _off^_usr   , Xu          , Xu          , Xu          , Xu          , Xu          , _off^_usr   , _off^_usr   
_off^_usr   , _off^_usr   , Xu          , Xu          , Uu          , Xu          , Xu          , Xu          , Uu          , Xu          , Uu          , Uh          , Uu          , Uu^Uf       , Uu^Uf       , Uh          , Uu          , Uu          , Qxu^Bs\     , Xu          , Uu          , Uu^Uf       , Uh          , Re          , Re          , Xu          , _off^_usr   
_off^_usr   , Xu          , Xu          , Uu^Uf       , Uu^Uf       , Uu          , Uh          , Uu          , Uu          , Uu^Uf       , Uu          , Uu          , Uu          , Uu          , Qxu         , Uu          , Uu          , Uu          , Qxu^Bs\     , Uu          , Uu          , Uu          , Re          , Re          , Re          , Xu          , _off^_usr   
_off^_usr   , _off^_usr   , Xu          , Uu^Uf       , Uu          , Uu          , Uu^Uf       , Uu          , Qxu         , Uu          , Uh          , Uh          , Uu          , Qxu         , Uu          , Uu^Uf       , Uh          , Uu          , Xu          , Uu          , Uu          , Uu          , Uu          , Uh          , Re          , Xu          , _off^_usr   
_off^_usr   , Xu          , Xu          , Uu^Uf       , Uu^Ii       , Uh          , Uu          , Uu          , Qxu         , Uu          , Uu          , Uu^Uf       , Uu          , Uu          , Uh          , Uu          , Xu          , Xu          , Mm^Xm       , Xu          , Uu          , Uu          , Xu          , Uu          , Xu          , Xu          , Mm^Xm       
_off^_usr   , Xu          , Uh          , Uu          , Uu^Ii       , Xu          , Uh          , Uu          , Uu          , Uu^Uf       , Uh          , Xu          , Xu          , Uh          , Uu          , Xu          , Mm^Xm       , Mm^Xm       , Mm^Xm       , Xu          , Wo          , Ww          , Xu          , Xu          , Mm^Xm       , Mm^Xm       , Mm          
_off^_usr   , Xu          , Uh          , Uu          , Uu^Ii       , Xu          , Xu          , Uh          , Uh          , Uu          , Uu          , Uh          , Xu          , Uu^Uf       , Xu          , Xu          , Mm^Xm       , Mm          , Hh          , Xu          , Ce          , Wo          , Xu          , Mm^Xm       , Mm          , Mm          , Gg          
Mm^Xm       , Xu          , Xu          , Uu          , Uu^Ii       , Uu^Ii       , Uu^Ii       , Xu          , Xu          , Xu          , Xu          , Xu          , Mm^Xm       , Xu          , Mm^Xm       , Mm^Xm       , Mm          , Hh          , Ce          , Ce          , Ce          , Xu          , Mm^Xm       , Mm^Xm       , Hh          , Hh          , Gs^Fp       
Mm          , Mm^Xm       , Mm^Xm       , Xu          , Uu^Ii       , Uu^Ii       , Uu^Ii       , Xu          , Xu          , Xu          , Mm^Xm       , Xu          , Mm^Xm       , Mm^Xm       , Hh          , Mm          , Hh          , Ce          , Ce          , 2 Ke        , Ce          , Ce          , Gs          , Hh          , Gs^Fp       , Gs^Fp       , Gs^Fp       
Mm          , Mm          , Mm^Xm       , Xu          , Cud         , Uu^Ii       , Re          , Uu^Ii       , Mm^Xm       , Mm^Xm       , Mm          , Mm^Xm       , Mm          , Mm          , Hh          , Hh          , Gg          , Ce          , Ce          , Ce          , Ce          , Ce          , Gs          , Gs          , Gg^Vc       , Hh          , Gs^Fp       
Hh          , Hh          , Mm          , Mm^Xm       , Ce          , Re          , Re          , Cud         , Ss          , Hh          , Gg^Fet      , Hh          , Hh          , Gg^Fet      , Gs^Fp       , Gg^Vc       , Hh          , Gg          , Re          , Re          , Ggf         , Gg          , Gs^Fp       , Gs^Fp       , Gg          , Gs^Fp       , Gg          
Hh          , Hh          , Hh          , Hh          , Re          , Re          , Re          , Gs          , Gs          , Gs^Fp       , Gg^Vc       , Gg          , Gs^Fp       , Hh          , Gg^Fet      , Gs^Fp       , Gs^Fp       , Gg          , Re          , Re          , Gs^Fp       , Gg^Fet      , Gg          , Gg^Vc       , Ds          , Ds          , Ds          
Gg          , Hh          , 3 Ke        , Gs^Fp       , Re          , Re          , Re          , Re          , Re          , Gs^Fp       , Gg^Fet      , Hh          , Gg^Fet      , Hh          , Gs          , Gs^Fp       , Gg^Vc       , Re          , Re          , Re          , Gs^Fp       , Gs^Fp       , Ds          , Ds          , Ww          , Ww          , Ww          
Gg          , Ce          , Ce          , Ce          , Gg^Fet      , Gg          , Gg^Vc       , Re          , Re          , Re          , Gs^Fp       , Gs          , Gs^Fp       , Gs^Fp       , Gg^Fet      , Gs          , Re          , Re          , Re          , Gg          , Hh          , Gg^Vc       , Gs^Fp       , Ds          , Ww          , Ww          , Ww          
Gg^Fet      , Gs^Fp       , Gg          , Gg          , Hh          , Gs^Fp       , Gg^Fet      , Gg          , Re          , Re          , Gs^Fp       , Gg^Fet      , Gs^Fp       , Gg^Vc       , Re          , Re          , Re          , Re          , Gs^Fp       , Gg^Fet      , Gs^Fp       , Gs^Fp       , Gg^Fet      , Ds          , Ww          , Ww          , Ww          
Hh          , Gs^Fp       , Gs^Fp       , Gg^Fet      , Gs^Fp       , Gg^Vc       , Gg          , Gg          , Re          , Re          , Re          , Re          , Re          , Re          , Re          , Re          , Gg^Fet      , Gs^Fp       , Hh          , Gs^Fp       , Gg          , Gg^Vc       , Gs^Fp       , Ds          , Ww          , Ww          , Ww          
Mm          , Gg^Fet      , Gs^Fp       , Hh          , Gs^Fp       , Gg          , Re          , Re          , Re          , Re          , Re          , Re          , Re          , Re          , Gs^Fp       , Gs^Fp       , Gs^Fp       , Gs^Fp       , Gg^Vc       , Gs^Fp       , Gs^Fp       , Gs^Fp       , Gg          , Ss          , Ss          , Ww          , Ww          
Hh          , Hh          , Gg          , Gg^Fet      , Gg          , Gg          , Re          , Re          , Gg          , Gg^Vc       , Gs^Fp       , Gs^Fp       , Gs          , Gs          , Gg^Fet      , Gs^Fp       , Gg^Fet      , Gg          , Gs^Fp       , Gg^Fet      , Gs^Fp       , Ggf         , Ss          , Gs^Fp       , Ss          , Ww          , Ww          
Mm          , Mm          , Mm          , Gs^Fp       , Gs^Fp       , Gg          , Re          , Re          , Gs^Fp       , Gs^Fp       , Gs^Fp       , Gg^Fet      , Gs^Fp       , Gs^Fp       , Gs^Fp       , Hh          , Ww          , Gs^Fp       , Ss          , Ww          , Ss          , Gs^Fp       , Ss          , Ww          , Ww          , Ww          , Ww          
Mm          , Mm          , Ce          , Mm          , Gs          , Gg          , Re          , Re          , Gg^Fet      , Gs^Fp       , Hh          , Gg^Vc       , Gs^Fp       , Gg^Fet      , Gg          , Gg          , Ss          , Ss          , Ss          , Gs^Fp       , Ss          , Ww          , Ww          , Gs^Fp       , Ww          , Ss          , Ww          
Hh          , Ce          , Mm          , Hh          , Gs          , Gg          , Re          , Re          , Gs^Fp       , Gg          , Gs^Fp       , Gg^Fet      , Ss          , Hh          , Ss          , Ww          , Ss          , Gs^Fp       , Ww          , Ww          , Ww          , Ww          , Ww          , Ss          , Ww          , Ww          , Ww          
Mm          , 1 Ke        , Mm          , Gs          , Gg          , Gg^Vc       , Re          , Re          , Gg          , Gg^Vc       , Gg          , Gg          , Ww          , Ww          , Ss          , Ss          , Ww          , Ss          , Ss          , Ww          , Ww          , Ww          , Gs^Fp       , Ww          , Ww          , Ww          , Ww          
Mm          , Ce          , Ce          , Hh          , Gg^Fet      , Re          , Re          , Re          , Gs^Fp       , Gs^Fp       , Ww          , Ss          , Ss          , Ss          , Ww          , Gs^Fp       , Ss          , Ww          , Ww          , Ww          , Gs^Fp       , Gg^Fet      , Gg          , Gg^Vc       , Ss          , Ww          , Ww          
Mm^Xm       , Mm          , Mm          , Hh          , Gs^Fp       , Re          , Re          , Gg^Fet      , Ww          , Ss          , Ss          , Gs^Fp       , Ss          , Ww          , Ss          , Ss          , Ww          , Ww          , Ww          , Ss          , Gg^Fet      , Gs          , Gg^Fet      , Gs^Fp       , Ss          , Ww          , Ww          
Mm^Xm       , Mm          , Gg^Fet      , Gg          , Re          , Re          , Re          , Ss          , Ss          , Ww          , Ss          , Ss          , Ww          , Ss          , Ww          , Ww          , Ww          , Ww          , Ww          , Ggf         , Gg^Vc       , Gs          , Ww          , Ss          , Ww          , Ww          , Ww          
Xu          , Xu          , Rr          , Re          , Re          , Re          , Gs^Fp       , Gs^Fp       , Ss          , Ss          , Gs^Fp       , Ww          , Ww          , Ww          , Ww          , Ww          , Ww          , Ww          , Ww          , Ww          , Ww          , Ww          , Ww          , Ww          , Ww          , Ww          , Ww          
Rr          , Rr          , Rr          , Rr          , Xu          , Mm^Xm       , Mm^Xm       , Ss          , Ww          , Ss          , Ss          , Ss          , Ww          , Ww          , Ww          , Ww          , Ww          , Ww          , Ww          , Ww          , Ww          , Ww          , Ww          , Ww          , Ww          , Ww          , Ww          
