border_size=1
usage=map

_off^_usr   , _off^_usr   , _off^_usr   , _off^_usr   , _off^_usr   , Xu          , Mm^Xm       , Mm          , Hh          , Hh          , Hh          , Hh          , Gg^Fet      , Gs^Fp       , Gs^Fp       , Re          , Re          , Re          , Gg          , Gg          , Ggf         , Gg          , Gs^Fp       , Ggf         , Ds          , Ww          , Ww          , Wo          , Wo          , Wo          , Wo          , Wo          , Wo          , Wo          , Wo          
_off^_usr   , _off^_usr   , _off^_usr   , _off^_usr   , _off^_usr   , Xu          , Mm^Xm       , Mm          , Mm          , Hh          , Hh          , Hh          , Hh          , Gs^Fp       , Re          , Re          , Re          , Ggf         , Gg^Fet      , Gg          , Gg          , Gg^Fet      , Ds          , Ds          , Ww          , Ww          , Ww          , Ww          , Wo          , Wo          , Wo          , Wo          , Wo          , Wo          , Wo          
_off^_usr   , _off^_usr   , _off^_usr   , _off^_usr   , _off^_usr   , Xu          , Xu          , Mm^Xm       , Mm^Xm       , Mm          , Mm^Xm       , Mm          , Mm          , Ggf         , Re          , Re          , Ggf         , Gg          , Gs^Fp       , Gs^Fp       , Gg          , Ds          , Ww          , Ww          , Ww          , Ww          , Ww          , Wo          , Wo          , Wo          , Wo          , Wo          , Wo          , Wo          , Wo          
_off^_usr   , _off^_usr   , _off^_usr   , _off^_usr   , Xu          , Xu          , Uu          , Xu          , Xu          , Mm^Xm       , Xu          , Mm^Xm       , Mm^Xm       , Re          , Re          , Re          , Hh          , Hh          , Hh          , Gg          , Ds          , Ds          , Ww          , Ww          , Wo          , Wo          , Wo          , Wo          , Wo          , Wo          , Wo          , Wo          , Wo          , Wo          , Wo          
_off^_usr   , _off^_usr   , _off^_usr   , _off^_usr   , Xu          , Uu          , Uu^Ii       , Uu          , Uu          , Xu          , Cud         , Xu          , Xu          , Re          , Re          , Mm          , Mm          , Hh          , Hh          , Hh          , Wwf         , Ww          , Ww          , Ww          , Wo          , Wo          , Ww          , Ww          , Ww          , Wo          , Wo          , Wo          , Wo          , Wo          , Wo          
_off^_usr   , _off^_usr   , _off^_usr   , _off^_usr   , Xu          , Uu          , Uu          , Uu          , Xu          , Uh          , Uh          , Rr          , Rr          , Xu          , Xu          , Mm^Xm       , Mm^Xm       , Mm          , Mm          , Hh          , Wwf         , Ww          , Ww          , Wo          , Wo          , Ww          , Ww          , Ww          , Ww          , Ww          , Wo          , Wo          , Wo          , Wo          , Wo          
_off^_usr   , _off^_usr   , _off^_usr   , _off^_usr   , _off^_usr   , Xu          , Xu          , Xu          , _off^_usr   , Xu          , Uu^Uf       , Rr          , Rr          , Rr          , Cud         , Xu          , Xu          , Mm^Xm       , Mm          , Hh          , Wwf         , Ww          , Ww          , Ww          , Ww          , Ww          , Ww          , Ww          , Ww          , Ww^Vm       , Ww          , Wo          , Ww          , Wo          , Wo          
_off^_usr   , _off^_usr   , _off^_usr   , _off^_usr   , _off^_usr   , _off^_usr   , _off^_usr   , _off^_usr   , Xu          , Xu          , Rr          , Rr          , Rr          , Rr          , Uh          , Xu          , Uu          , Xu          , Xu          , Hh          , Wwf         , Ww          , Ww          , Ww          , Ww          , Ww          , Ss^Vm       , Ww          , Ww          , Ww          , Ww          , Ww          , Ww          , Wo          , Ww          
_off^_usr   , _off^_usr   , _off^_usr   , _off^_usr   , _off^_usr   , _off^_usr   , _off^_usr   , _off^_usr   , _off^_usr   , Xu          , Rr          , Rr          , Rr          , Uu          , Xu          , Uu          , Uu^Ii       , Uu          , Xu          , Wwf         , Ww          , Ww^Vm       , Ww          , Ww          , Ww          , Ss          , Ss          , Ww          , Ww          , Ww          , Ww          , Ww          , Ss          , Ww          , Ss          
_off^_usr   , _off^_usr   , _off^_usr   , _off^_usr   , _off^_usr   , _off^_usr   , _off^_usr   , _off^_usr   , _off^_usr   , Xu          , Uu          , Rr          , Rr          , Rr          , Xu          , Uu          , Uu          , Uu          , Xu          , Ww          , Ww          , Ww          , Ww          , Ww          , Ss          , Chs         , Ss          , Ww          , Ss          , Ww          , Ww          , Ss          , Ww          , Ww          , Ss          
_off^_usr   , _off^_usr   , _off^_usr   , _off^_usr   , _off^_usr   , _off^_usr   , _off^_usr   , _off^_usr   , _off^_usr   , Xu          , Uh          , Rr          , Rr          , Rr          , Uu          , Xu          , Xu          , Xu          , Xu          , Xu          , Xu          , Ww          , Ww          , Ss          , Ww          , Ww          , Ss          , Ww          , Ww          , Ww          , Ss          , Ww          , Ss          , Ss          , Ww          
_off^_usr   , _off^_usr   , _off^_usr   , _off^_usr   , _off^_usr   , _off^_usr   , _off^_usr   , _off^_usr   , _off^_usr   , Xu          , Xu          , Rr          , Rr          , Rr          , Uu^Uf       , Xu          , Xu          , Xu          , Xu          , Xu          , Xu          , Ww          , Ww          , Ww          , Ss          , Ww          , Ww          , Chs         , Ww          , Ss          , Ww          , Gs^Fp       , Ss          , Chs         , Ww          
_off^_usr   , _off^_usr   , _off^_usr   , _off^_usr   , _off^_usr   , _off^_usr   , _off^_usr   , _off^_usr   , _off^_usr   , Xu          , Xu          , Rr          , Rr          , Rr          , Rr          , Uu          , Xu          , Xu          , Xu          , Xu          , Xu          , Xu          , Ww          , Ww          , Ww          , Ss          , Ss          , Ww          , Ss          , Ww          , Ss          , Ss          , Gs^Fp       , Ww          , Gs^Fp       
_off^_usr   , _off^_usr   , _off^_usr   , _off^_usr   , _off^_usr   , _off^_usr   , _off^_usr   , _off^_usr   , _off^_usr   , Xu          , Xu          , Xu          , Xu          , Rr          , Rr          , Rr          , Rr          , Xu          , Xu          , Xu          , Cud         , Xu          , Xu          , Ww          , Ww          , Ss          , Ww          , Ww          , Ss          , Ss          , Ss          , Gg          , Ss          , Gs^Fp       , Ww          
_off^_usr   , _off^_usr   , _off^_usr   , _off^_usr   , _off^_usr   , _off^_usr   , _off^_usr   , _off^_usr   , _off^_usr   , _off^_usr   , _off^_usr   , _off^_usr   , Xu          , Rr          , Rr          , Rr          , Rr          , Rr          , Rr          , Rr          , Rr          , Uh          , Qxu         , Xu          , Xu          , Ww          , Ss          , Ww          , Gs^Fp       , Ss          , Ss          , Ss          , Gs^Fp       , Gg          , Hh          
_off^_usr   , _off^_usr   , _off^_usr   , _off^_usr   , _off^_usr   , _off^_usr   , _off^_usr   , _off^_usr   , _off^_usr   , _off^_usr   , Xu          , _off^_usr   , Xu          , Xu          , Xu          , Rr          , Rr          , Rr          , Rr          , Uu^Vud      , Qxu         , Qxu^Bs\     , Cud         , Cud         , 2 Kud       , Xu          , Xu          , Ww          , Gg          , Gs^Fp       , Hh          , Gs^Fp       , Hh          , Hh          , Mm          
_off^_usr   , _off^_usr   , _off^_usr   , _off^_usr   , _off^_usr   , _off^_usr   , _off^_usr   , _off^_usr   , _off^_usr   , Xu          , Uu^Uf       , Xu          , Uu          , Uu^Uf       , Uh          , Cud         , Rr          , Uh          , Uu^Uf       , Qxu^Bs\     , Cud         , Cud         , Kud         , Cud         , Cud         , Cud         , Qxu         , Xu          , Xu          , Hh          , Mm          , Hh          , Mm^Xm       , Mm          , Mm^Xm       
_off^_usr   , _off^_usr   , _off^_usr   , _off^_usr   , _off^_usr   , _off^_usr   , _off^_usr   , _off^_usr   , _off^_usr   , Xu          , Uu          , Uu          , Cud         , Qxu         , Qxu^Bs/     , Rr          , Uu          , Rr          , Uu^Uf       , Qxu         , Qxu         , Qxu         , Cud         , Cud         , Qxu         , Qxu^Bs\     , Rr          , Uu          , Uu^Vud      , Xu          , Xu          , Mm^Xm       , Xu          , Mm^Xm       , Xu          
_off^_usr   , _off^_usr   , _off^_usr   , _off^_usr   , _off^_usr   , _off^_usr   , _off^_usr   , _off^_usr   , Xu          , Xu          , Uu          , Uu^Vud      , Rr          , Rr          , Qxu         , Qxu         , Uu          , Rr          , Rr          , Uh          , Uu^Vud      , Qxu         , Qxu         , Qxu^Bs\     , Rr          , Uu^Vud      , Rr          , Rr          , Uu          , Uh          , Xu          , Xu          , _off^_usr   , Xu          , _off^_usr   
_off^_usr   , _off^_usr   , _off^_usr   , _off^_usr   , _off^_usr   , _off^_usr   , _off^_usr   , _off^_usr   , Xu          , Uu^Vud      , Rr          , Rr          , Rr          , Cud         , Qxu         , Uu^Uf       , Uu          , Uu^Vud      , Rr          , Rr          , Rr          , Uu          , Uu^Vud      , Uu          , Rr          , Rr          , Xu          , Uh          , Xu          , Uh          , Xu          , _off^_usr   , _off^_usr   , _off^_usr   , _off^_usr   
_off^_usr   , _off^_usr   , _off^_usr   , _off^_usr   , _off^_usr   , _off^_usr   , _off^_usr   , _off^_usr   , Xu          , Uh          , Uu          , Uu          , Cud         , Rr          , Qxu^Bs\     , Uu          , Rr          , Rr          , Rr          , Cud         , Uh          , Rr          , Uh          , Rr          , Xu          , Xu          , _off^_usr   , Xu          , _off^_usr   , Xu          , _off^_usr   , _off^_usr   , _off^_usr   , _off^_usr   , _off^_usr   
_off^_usr   , _off^_usr   , _off^_usr   , _off^_usr   , _off^_usr   , _off^_usr   , _off^_usr   , _off^_usr   , Xu          , Uu          , Xu          , Uh          , Qxu         , Qxu         , Uu^Uf       , Rr          , Uu          , Uu^Vud      , Rr          , Uu          , Uu          , Rr          , Rr          , Rr          , Uu^Uf       , Xu          , Xu          , _off^_usr   , _off^_usr   , _off^_usr   , _off^_usr   , _off^_usr   , _off^_usr   , _off^_usr   , _off^_usr   
_off^_usr   , _off^_usr   , _off^_usr   , _off^_usr   , _off^_usr   , _off^_usr   , _off^_usr   , _off^_usr   , _off^_usr   , Xu          , _off^_usr   , Xu          , Qxu         , Uu          , Uu          , Uu^Vud      , Uh          , Uu          , Rr          , Uh          , Xu          , Rr          , Uu          , Uh          , Uu          , Uh          , Uh          , Xu          , _off^_usr   , _off^_usr   , _off^_usr   , _off^_usr   , _off^_usr   , _off^_usr   , _off^_usr   
_off^_usr   , _off^_usr   , _off^_usr   , _off^_usr   , _off^_usr   , _off^_usr   , _off^_usr   , _off^_usr   , _off^_usr   , _off^_usr   , _off^_usr   , Xu          , Xu          , Xu          , Xu          , Uh          , Xu          , Uu^Vud      , Xu          , Xu          , Qxu         , Xu          , Uh          , Uu          , Re          , Uu          , Uu          , Xu          , Xu          , _off^_usr   , _off^_usr   , _off^_usr   , _off^_usr   , _off^_usr   , _off^_usr   
_off^_usr   , _off^_usr   , _off^_usr   , _off^_usr   , _off^_usr   , _off^_usr   , _off^_usr   , _off^_usr   , _off^_usr   , _off^_usr   , _off^_usr   , _off^_usr   , _off^_usr   , _off^_usr   , _off^_usr   , Xu          , _off^_usr   , Xu          , Qxu         , Uu          , Qxu         , Xu          , Xu          , Uu          , Uu          , Re          , Uu          , Uu^Vud      , Xu          , _off^_usr   , _off^_usr   , _off^_usr   , _off^_usr   , _off^_usr   , _off^_usr   
_off^_usr   , _off^_usr   , _off^_usr   , _off^_usr   , _off^_usr   , _off^_usr   , _off^_usr   , _off^_usr   , _off^_usr   , _off^_usr   , _off^_usr   , _off^_usr   , _off^_usr   , _off^_usr   , _off^_usr   , _off^_usr   , _off^_usr   , Xu          , Xu          , Qxu         , Qxu         , Uu          , Xu          , Uu^Uf       , Uu          , Re          , Uu          , Uh          , Uu          , Xu          , Xu          , _off^_usr   , _off^_usr   , _off^_usr   , _off^_usr   
_off^_usr   , _off^_usr   , _off^_usr   , _off^_usr   , _off^_usr   , _off^_usr   , _off^_usr   , _off^_usr   , _off^_usr   , _off^_usr   , _off^_usr   , _off^_usr   , _off^_usr   , _off^_usr   , Xu          , Xu          , Xu          , Xu          , Re          , Xu          , Uh          , Qxu         , Uu          , Cud         , Uu          , Re          , Uh          , Uh          , Qxu         , Uh          , Xu          , _off^_usr   , _off^_usr   , _off^_usr   , _off^_usr   
_off^_usr   , _off^_usr   , _off^_usr   , _off^_usr   , _off^_usr   , _off^_usr   , _off^_usr   , _off^_usr   , _off^_usr   , _off^_usr   , _off^_usr   , _off^_usr   , Xu          , Xu          , Uh          , Uu^Vud      , Uu^Uf       , Uh          , Uu          , Uu          , Uu          , Uu^Uf       , Re          , Re          , Re          , Uu          , Uu          , Qxu         , Uu          , Uh          , Xu          , _off^_usr   , _off^_usr   , _off^_usr   , _off^_usr   
_off^_usr   , _off^_usr   , _off^_usr   , _off^_usr   , _off^_usr   , _off^_usr   , _off^_usr   , _off^_usr   , _off^_usr   , _off^_usr   , _off^_usr   , Xu          , Uh          , Uh          , Uu          , Uu          , Re          , Re          , Re          , Re          , Uh          , Uu          , Re          , Re          , Qxu         , Uu^Uf       , Qxu         , Qxu         , Uu^Uf       , Xu          , _off^_usr   , _off^_usr   , _off^_usr   , _off^_usr   , _off^_usr   
_off^_usr   , _off^_usr   , _off^_usr   , _off^_usr   , _off^_usr   , _off^_usr   , _off^_usr   , _off^_usr   , _off^_usr   , _off^_usr   , Xu          , Xu          , Uu          , Uu          , Uu          , Uu          , Uu          , Uh          , Uu          , Uu          , Uu^Uf       , Uh          , Uu^Uf       , Uu^Vud      , Uu          , Qxu         , Uu          , Uu          , Xu          , Xu          , _off^_usr   , _off^_usr   , _off^_usr   , _off^_usr   , _off^_usr   
_off^_usr   , _off^_usr   , _off^_usr   , _off^_usr   , _off^_usr   , _off^_usr   , _off^_usr   , _off^_usr   , _off^_usr   , Xu          , Uu^Uf       , Uu^Uf       , Re          , Re          , Cud         , Cud         , Cud         , Xu          , Xu          , Xu          , Xu          , Uh          , Xu          , Xu          , Uh          , Qxu         , Uh          , Xu          , _off^_usr   , _off^_usr   , _off^_usr   , _off^_usr   , _off^_usr   , _off^_usr   , _off^_usr   
_off^_usr   , _off^_usr   , _off^_usr   , _off^_usr   , _off^_usr   , _off^_usr   , _off^_usr   , _off^_usr   , _off^_usr   , Xu          , Uh          , Re          , Uu^Uf       , Uu          , Cud         , 1 Kud       , Qxu         , Xu          , Xu          , _off^_usr   , _off^_usr   , Xu          , _off^_usr   , Xu          , Xu          , Uh          , Xu          , Xu          , _off^_usr   , _off^_usr   , _off^_usr   , _off^_usr   , _off^_usr   , _off^_usr   , _off^_usr   
_off^_usr   , _off^_usr   , _off^_usr   , _off^_usr   , _off^_usr   , _off^_usr   , _off^_usr   , _off^_usr   , Xu          , Xu          , Uh          , Uh          , Uu          , Uu          , Qxu         , Qxu         , Xu          , Xu          , Xu          , _off^_usr   , _off^_usr   , _off^_usr   , _off^_usr   , _off^_usr   , _off^_usr   , Xu          , _off^_usr   , _off^_usr   , _off^_usr   , _off^_usr   , _off^_usr   , _off^_usr   , _off^_usr   , _off^_usr   , _off^_usr   
